6 0 0 0 0 0 0 0 0 0 0 0 0 0 0 0 0 0 0 0 
2 2 2 2 7 17 7 17 7 17 7 2 0 0 0 0 0 0 17 7 
0 0 0 1 2 2 2 2 2 2 2 2 3 0 0 0 0 0 1 2 
8 0 0 0 0 0 0 0 0 0 0 0 0 0 0 0 0 0 0 0 
3 0 12 0 0 0 0 0 0 0 0 0 0 0 1 0 12 0 0 1 
0 0 0 0 0 8 0 0 0 0 17 17 0 0 0 0 0 0 0 17 
3 0 0 0 16 2 0 16 0 0 1 3 0 16 0 16 2 0 1 2 
0 0 0 0 0 0 0 0 0 0 0 0 0 0 0 0 0 0 0 1 
0 0 0 0 7 0 0 0 0 0 7 0 0 7 0 0 0 17 0 0 
3 0 0 2 2 3 0 0 0 1 3 0 1 2 3 12 0 1 3 0 
0 0 0 1 2 3 0 0 0 1 0 0 0 0 0 0 0 0 0 0 
3 0 0 0 0 2 7 17 7 2 0 0 0 0 0 0 0 0 0 0 
0 0 0 1 0 1 2 2 2 3 0 0 0 0 0 0 0 12 1 8 
3 0 0 0 0 0 0 0 0 0 0 0 16 0 0 0 16 0 0 16 
0 0 0 1 0 0 0 0 0 0 0 0 0 0 0 0 0 0 0 17 
3 12 0 0 0 0 0 0 12 0 0 0 0 0 1 8 3 0 17 1 
0 0 0 1 3 0 17 0 0 17 0 0 17 0 1 2 3 0 1 2 
0 5 0 1 0 0 3 0 0 1 0 0 3 0 0 0 0 0 0 0 
0 2 0 0 0 0 0 0 0 0 0 0 0 0 0 0 0 0 0 0 
4 4 4 4 4 4 4 4 4 4 4 4 4 4 4 4 4 4 4 4 
