0 0 0 0 0 0 0 0 0 0 0 0 0 0 0 0 0 0 0 0 
17 0 0 0 0 0 7 0 17 5 0 7 0 0 0 0 0 17 0 0 
2 3 0 0 1 2 2 2 2 2 2 2 2 3 0 1 2 2 3 0 
3 0 0 0 0 0 0 0 12 2 0 0 12 0 0 0 1 3 0 0 
0 0 17 0 0 17 0 0 0 17 0 0 0 0 17 0 0 17 0 0 
0 1 2 2 2 2 3 0 1 2 3 0 1 2 2 2 2 2 2 2 
0 1 0 2 12 0 0 0 1 2 3 0 0 0 0 0 12 0 0 1 
17 0 0 2 0 0 0 0 0 17 0 0 17 0 0 0 0 0 0 8 
2 3 0 2 3 0 1 2 2 2 2 2 2 3 0 2 0 1 2 2 
0 3 0 0 0 0 12 0 0 0 0 0 0 3 0 0 0 0 12 1 
0 0 0 0 7 0 17 0 0 0 0 0 17 2 0 17 0 0 0 0 
0 1 2 2 2 2 2 2 3 0 1 2 2 2 2 2 2 2 3 0 
0 0 0 0 0 0 0 0 0 0 1 0 0 0 0 0 0 12 3 0 
0 0 8 0 0 0 0 0 0 0 0 0 17 17 0 0 0 0 17 0 
16 1 2 3 0 1 2 2 2 16 16 16 2 2 2 3 0 0 1 2 
0 0 0 3 0 0 0 12 3 0 0 0 0 0 0 0 0 12 1 2 
7 17 8 0 0 17 0 0 0 0 7 0 17 0 0 0 0 0 0 0 
2 2 2 2 2 2 2 2 2 2 2 2 2 2 2 2 2 2 2 2 
2 8 0 0 0 0 0 0 0 6 0 0 0 0 17 0 17 0 17 2 
2 2 2 2 2 2 2 2 2 2 2 2 2 2 2 2 2 2 2 2