0 0 0 0 0 0 0 17 0 0 0 2 17 0 0 0 0 0 0 0 
0 5 0 17 0 0 0 1 3 0 0 2 3 0 0 0 0 7 8 17 
2 2 2 3 0 0 0 0 0 0 1 2 17 0 0 0 1 2 2 2 
0 0 0 0 0 0 0 0 0 17 0 2 3 0 0 0 0 0 0 0 
0 0 0 17 0 0 16 0 0 2 0 2 0 0 0 1 3 0 0 0 
0 1 2 2 4 4 4 4 4 2 0 2 0 1 4 4 4 4 3 0 
17 0 0 1 2 2 2 2 2 3 0 2 0 1 2 2 2 2 3 0 
3 0 0 0 0 0 0 0 0 0 17 2 0 0 17 0 0 0 0 17 
0 0 16 0 0 0 0 17 2 2 2 2 2 2 2 3 0 0 12 1 
0 0 0 0 0 0 0 1 2 0 0 0 0 0 2 0 0 0 0 17 
0 7 17 7 0 0 0 0 2 17 0 6 0 0 2 0 0 1 2 2 
0 1 2 2 16 16 16 16 2 2 2 2 3 0 2 0 0 1 0 17 
0 0 0 0 0 0 0 0 2 0 12 0 0 17 2 17 0 0 0 1 
3 0 17 0 0 0 0 0 2 0 17 8 0 1 2 3 0 0 0 0 
2 2 2 3 0 0 0 0 2 2 2 2 2 2 2 0 0 16 0 17 
3 8 12 0 0 0 0 0 0 0 1 2 3 0 0 0 0 0 12 1 
2 2 3 0 0 16 0 0 0 0 0 0 0 0 0 0 0 0 8 17 
17 0 17 0 0 0 16 0 17 0 0 0 0 0 0 17 0 1 2 2 
2 2 2 3 0 0 0 1 3 0 16 0 16 0 1 3 0 0 0 0 
4 4 4 4 4 4 4 4 4 4 4 4 4 4 4 4 4 4 4 4