0 0 0 0 0 0 0 0 0 0 0 0 0 0 0 0 0 0 0 0 
0 0 0 0 0 0 0 0 0 0 16 0 0 0 12 0 0 0 0 0 
6 0 0 7 0 16 0 3 0 0 0 0 2 0 0 17 0 0 0 0 
2 2 2 3 0 0 0 0 0 0 0 1 2 2 2 3 0 3 0 0 
0 0 0 2 4 4 4 4 4 4 4 2 0 0 0 0 0 0 0 1 
0 0 0 2 2 2 2 2 2 2 2 2 0 0 7 17 0 0 0 0 
0 0 0 0 0 0 0 0 0 0 0 0 0 1 2 3 16 0 0 0 
0 0 0 0 0 0 0 0 0 0 0 0 0 2 8 0 0 0 0 0 
8 0 0 0 1 3 0 2 0 2 0 1 2 2 3 0 0 0 0 0 
2 3 0 0 12 0 0 0 0 0 0 0 0 0 0 0 0 0 0 1 
0 0 0 0 0 17 7 17 7 17 7 17 0 0 0 0 0 0 0 0 
0 0 16 0 2 2 2 2 2 2 2 2 2 4 2 17 0 0 0 1 
0 0 0 0 0 0 0 0 0 0 0 0 1 2 2 2 3 0 0 2 
12 0 0 0 0 0 0 0 0 0 0 0 0 0 0 17 0 0 0 2 
0 5 0 0 0 0 0 0 0 0 0 0 0 7 1 2 2 0 16 2 
2 2 3 12 0 0 0 0 0 0 0 0 1 2 2 0 0 0 0 0 
0 0 0 0 0 0 0 0 0 17 0 0 0 0 0 0 0 8 0 1 
0 0 16 0 0 0 0 1 2 2 3 0 0 0 0 0 1 2 3 0 
0 0 0 0 0 0 0 0 0 0 0 0 0 0 0 0 0 0 0 0 
4 4 4 4 4 4 4 4 4 4 4 4 4 4 4 4 4 4 4 4