17 0 0 0 0 0 0 0 0 0 0 0 0 0 0 0 0 0 0 8 
3 0 0 0 0 0 0 0 0 0 0 0 0 0 0 0 0 12 17 1 
0 5 0 0 17 7 0 0 7 17 0 0 0 7 0 17 0 0 1 2 
2 2 2 2 2 2 3 0 1 3 0 2 0 1 2 3 0 0 0 0 
17 0 0 0 0 0 0 0 0 0 0 0 0 0 0 0 0 0 0 17 
3 12 0 0 0 0 0 0 0 0 0 0 12 0 0 0 0 0 0 1 
0 0 0 0 7 0 0 0 17 0 0 0 0 0 17 0 0 17 0 0 
17 0 0 0 1 2 4 4 2 4 4 2 4 4 2 4 4 2 3 0 
3 12 0 0 0 1 2 2 2 2 2 2 2 2 2 2 2 2 0 0 
0 0 0 0 0 0 0 0 0 0 0 0 0 0 0 0 0 0 0 0 
8 17 0 7 0 0 0 0 0 0 0 0 0 7 0 0 0 0 0 0 
2 3 0 1 2 3 0 0 16 16 0 0 1 2 3 12 0 0 0 1 
17 0 0 0 0 0 0 0 0 0 0 0 0 0 0 0 0 0 0 0 
3 0 0 0 0 0 0 0 0 12 0 0 0 0 0 0 0 0 0 1 
0 0 0 0 0 17 0 0 0 0 0 0 0 0 17 0 0 0 0 17 
17 0 0 0 1 3 16 0 16 2 16 0 16 16 2 16 16 0 1 2 
2 3 0 0 0 0 0 0 0 0 0 0 0 0 0 12 0 0 0 1 
2 3 0 16 0 0 0 0 0 0 0 17 0 0 0 0 0 0 0 0 
0 0 17 0 0 0 0 16 0 17 0 1 3 0 0 0 16 0 17 6 
4 4 2 4 4 2 4 4 4 2 4 4 4 4 2 4 4 4 2 2 
