2 2 2 2 2 2 2 2 2 2 2 2 2 2 2 2 2 2 2 2 
2 0 0 0 0 2 0 0 0 0 0 0 0 0 0 0 0 0 0 2 
2 5 17 0 0 2 0 0 0 0 12 0 0 0 0 0 12 0 0 2 
2 2 3 0 0 2 8 0 7 17 7 17 7 17 7 0 0 0 0 2 
2 0 0 12 0 2 2 2 2 2 2 2 2 2 2 2 3 0 0 2 
2 0 0 17 0 2 0 0 0 12 0 0 2 0 0 2 0 0 17 2 
2 0 0 1 2 2 0 0 17 7 17 0 2 0 0 2 0 0 1 2 
2 0 0 12 0 2 17 0 1 2 3 0 2 0 8 2 17 0 0 2 
2 17 0 0 0 2 3 0 2 6 0 17 2 0 1 2 3 0 0 2 
2 2 2 3 0 2 3 0 2 2 2 2 3 0 0 2 3 0 0 2 
2 0 0 0 0 1 0 17 2 0 0 0 0 0 0 2 0 0 17 2 
2 0 17 0 0 2 0 1 2 8 0 0 16 0 0 2 0 0 1 2 
2 0 1 2 2 2 8 17 2 3 17 17 12 17 17 2 17 0 0 2 
2 0 0 0 0 1 2 2 2 2 2 2 2 2 2 2 3 0 0 2 
2 0 0 0 0 12 0 0 2 0 0 0 12 0 0 0 0 0 0 1 
2 0 17 0 0 0 17 0 0 17 7 17 0 0 0 17 7 17 0 2 
2 0 1 3 0 1 3 0 0 1 2 3 0 0 0 1 2 3 0 2 
2 0 1 0 0 0 0 0 0 0 0 0 0 0 0 0 0 3 0 2 
2 17 0 0 16 0 0 16 0 0 0 0 0 16 0 0 0 0 17 2 
2 2 4 4 4 4 4 4 4 4 4 4 4 4 4 4 4 4 2 2 
