0 0 0 0 0 0 0 0 0 0 0 0 0 0 0 0 0 0 17 6 
0 0 0 0 0 17 0 0 0 0 0 0 0 0 17 0 0 0 1 2 
0 8 17 0 0 1 3 0 0 16 0 0 0 0 1 3 0 0 0 0 
1 2 3 0 0 0 0 0 0 0 0 17 0 0 0 0 0 0 0 0 
0 0 0 0 0 0 0 0 0 0 1 3 0 0 0 0 16 0 17 8 
0 0 0 16 0 0 17 0 16 0 0 0 0 16 0 0 0 0 1 2 
0 0 0 0 0 1 3 0 0 0 0 0 0 0 0 0 0 0 0 0 
8 17 0 16 0 0 0 0 0 0 0 0 0 0 0 0 16 0 0 0 
2 3 0 0 0 0 0 0 16 0 17 8 0 0 16 0 0 0 0 0 
0 0 16 0 0 0 0 0 0 0 1 2 3 0 0 0 0 0 0 0 
0 0 0 0 16 0 0 0 0 0 0 0 0 0 16 0 0 0 0 0 
0 0 0 0 0 0 1 3 0 16 0 17 0 0 0 0 16 0 17 8 
17 8 0 0 0 0 0 0 0 0 0 1 3 0 0 0 0 0 1 2 
1 2 3 0 16 0 0 17 0 0 0 0 0 16 0 0 0 0 0 0 
0 0 0 0 0 0 1 3 0 0 0 17 8 0 0 0 16 0 0 17 
0 0 0 0 0 0 0 0 0 0 0 1 2 3 0 12 0 0 0 1 
0 16 0 0 0 8 17 0 16 0 0 0 0 0 0 0 0 0 0 17 
0 0 0 0 1 2 3 12 0 0 0 0 0 0 0 0 0 0 0 1 
0 5 0 0 0 0 0 0 0 0 7 17 7 17 7 0 0 0 17 8 
2 2 2 2 2 2 2 2 2 2 2 2 2 2 2 2 2 2 2 2 