2 2 2 2 2 2 2 2 2 2 2 2 2 2 2 2 2 2 2 2 
2 8 0 0 0 0 0 12 0 0 0 0 0 0 0 0 0 0 0 2 
2 3 0 0 0 0 0 0 17 0 0 0 17 0 17 0 0 5 0 2 
2 0 0 0 1 2 2 2 2 2 2 2 2 2 2 2 2 2 2 2 
2 17 0 0 0 0 0 0 0 0 0 0 0 0 0 0 0 0 0 2 
2 3 0 0 0 0 0 0 0 0 0 12 0 0 0 0 0 0 0 2 
2 0 0 0 0 17 0 17 0 17 0 17 0 0 17 0 17 0 8 2 
2 0 0 0 1 2 4 2 4 2 4 2 4 2 2 4 2 0 2 2 
2 12 0 0 0 1 2 2 2 2 2 2 2 2 2 2 3 0 0 2 
2 3 0 0 0 0 0 0 0 12 0 0 0 0 0 0 0 0 0 1 
2 0 0 0 0 17 0 0 17 0 0 0 17 0 0 0 0 17 17 2 
2 0 0 0 1 2 16 16 2 16 16 2 2 16 16 16 2 2 2 2 
2 8 0 0 12 2 0 0 0 0 0 0 0 0 0 0 0 0 0 2 
2 3 0 0 0 0 0 0 0 0 0 0 0 0 0 0 0 0 0 1 
2 0 0 0 0 0 0 0 16 0 0 16 0 0 7 17 7 0 0 2 
2 17 0 0 1 2 2 4 4 4 4 4 4 2 2 2 2 3 0 2 
2 3 0 0 0 0 1 2 2 2 2 2 2 3 12 0 0 0 0 1 
2 0 0 0 0 0 0 0 0 0 0 0 0 0 0 0 0 0 0 1 
2 0 0 0 0 0 7 0 0 7 0 0 7 0 7 0 6 0 7 2 
2 4 4 4 2 2 2 2 2 2 2 2 2 2 2 2 2 2 2 2