8 0 0 0 0 0 0 0 1 2 3 0 0 0 0 0 0 0 0 0 
3 0 0 0 0 0 0 0 0 12 0 0 0 0 0 0 0 16 0 1 
0 0 17 16 0 0 17 0 0 17 0 0 17 0 16 0 0 0 0 0 
17 0 1 0 0 0 1 4 4 2 4 4 3 0 0 0 17 0 0 8 
3 0 0 0 0 0 1 2 2 2 2 2 3 0 0 1 2 3 0 1 
0 17 7 12 0 0 0 0 0 2 0 0 0 0 0 17 0 17 0 1 
0 1 2 3 0 0 0 0 0 2 17 0 0 2 4 2 0 2 4 2 
0 0 2 0 0 0 0 0 0 2 2 3 0 2 2 2 0 2 2 2 
3 0 2 2 2 4 4 2 0 1 0 0 0 1 0 3 0 0 0 17 
17 0 0 0 1 2 2 3 0 2 0 0 0 0 12 0 0 0 0 1 
2 3 0 0 0 0 12 0 0 2 0 17 16 0 0 0 16 0 17 0 
0 0 0 17 7 17 0 0 16 2 0 2 4 4 4 4 4 4 2 0 
0 0 1 2 2 2 3 0 0 2 0 1 2 2 2 2 2 2 3 0 
3 0 0 12 0 2 0 0 0 2 0 0 0 0 0 0 0 0 0 17 
3 0 0 0 0 0 0 0 16 2 16 17 0 0 1 2 3 0 0 1 
0 0 0 0 0 17 2 0 17 2 4 2 0 0 17 2 0 0 0 0 
0 0 1 3 0 1 3 0 2 2 2 2 0 1 2 2 2 2 3 0 
3 0 0 12 0 0 0 0 0 2 0 0 0 0 0 2 0 0 0 17 
8 17 7 0 2 17 7 0 5 2 6 0 7 0 0 2 17 12 17 1 
2 2 2 2 2 2 2 2 2 2 2 2 2 2 2 2 2 2 2 2 